H#H#H#H#H#H#H#H#H#H#H#H#H#H#H#H#H#H#H#H#
a`a`a`a`a`a`a`a`a`a`a`a`a`a`a`a`a`a`a`a`
b`b`b`b`b`b`b`b`b`b`b`b`b`b`b`b`b`b`b`b`
c`c`c`c`c`c`c`c`c`c`c`c`c`c`c`c`c`c`c`c`
d`d`d`d`d`d`d`d`d`d`d`d`d`d`d`d`d`d`d`d`
e`e`e`e`e`e`e`e`e`e`e`e`e`e`e`e`e`e`e`e`
f`f`f`f`f`f`f`f`f`f`f`f`f`f`f`f`f`f`f`f`
g`g`g`g`g`g`g`g`g`g`g`g`g`g`g`g`g`g`g`g`
h`h`h`h`h`h`h`h`h`h`h`h`h`h`h`h`h`h`h`h`
i`i`i`i`i`i`i`i`i`i`i`i`i`i`i`i`i`i`i`i`
j`j`j`j`j`j`j`j`j`j`j`j`j`j`j`j`j`j`j`j`
k`k`k`k`k`k`k`k`k`k`k`k`k`k`k`k`k`k`k`k`
l`l`l`l`l`l`l`l`l`l`l`l`l`l`l`l`l`l`l`l`
m`m`m`m`m`m`m`m`m`m`m`m`m`m`m`m`m`m`m`m`
H#H#H#H#H#H#H#H#H#H#H#H#H#H#H#H#H#H#H#H#