1w1w1w1w
1w````1w
1w````1w
1w1w``1w
1w1w``1w