1w1w1w1w1w
1w``2`2`1w
1w2`3`2`1w
1w1w2`2`1w
1w1w2`2`1w
1w1w1w1w1w